FE8 - Castle - 1800481a
28 27
424 424 424 424 424 424 424 424 883 883 883 883 884 885 883 884 883 884 885 424 424 424 424 424 424 424 424
424 785 785 785 785 785 785 424 915 915 911 912 916 916 916 911 912 917 917 424 785 785 785 785 785 785 424
424 785 785 785 785 785 785 424 947 625 943 944 948 948 948 946 944 625 628 424 785 785 785 785 785 785 424
424 785 785 785 785 785 785 421 947 625 625 625 947 625 628 625 625 625 628 423 785 785 785 785 785 785 424
424 785 785 785 785 785 785 424 976 627 627 627 947 625 628 627 627 627 981 424 785 785 785 785 785 785 424
424 785 785 785 785 785 785 424 721 721 721 721 947 625 628 721 721 721 721 424 785 785 785 785 785 785 424
424 425 425 452 453 425 425 424 721 721 721 721 976 627 981 721 721 721 721 424 425 425 452 453 425 425 424
424 721 721 721 721 721 721 424 721 721 721 721 721 721 721 721 721 721 721 424 721 721 721 721 721 721 424
424 721 721 721 721 721 721 424 424 424 424 424 452 454 453 424 424 424 424 424 721 721 721 721 721 721 424
424 721 721 721 721 721 721 721 721 721 721 721 721 721 721 721 721 721 721 721 721 721 721 721 721 721 424
424 721 721 721 721 721 721 721 721 721 721 721 721 721 721 721 721 721 721 721 721 721 721 721 721 721 424
424 424 424 721 721 721 721 721 721 721 721 721 721 721 721 721 721 721 721 721 721 721 721 721 424 424 424
424 419 424 721 721 721 721 721 721 424 424 424 452 454 453 424 424 424 721 721 721 721 721 721 424 419 424
424 785 424 721 721 721 721 721 721 424 785 785 785 785 785 785 785 424 721 721 721 721 721 721 424 785 424
424 785 424 721 721 721 721 721 721 424 785 785 785 785 785 785 785 424 721 721 721 721 721 721 424 785 424
424 785 424 424 424 424 424 452 453 424 785 785 785 785 785 785 785 424 452 453 424 424 424 424 424 785 424
424 785 785 785 785 785 785 785 785 785 785 785 785 785 785 785 785 785 785 785 785 785 785 785 785 785 424
424 785 785 785 785 785 785 785 785 785 785 785 785 785 785 785 785 785 785 785 785 785 785 785 785 785 424
424 785 785 785 785 785 785 785 785 785 424 424 424 424 424 424 424 785 785 785 785 785 785 785 785 785 424
424 785 785 785 785 785 785 785 785 785 424 721 721 721 721 721 424 785 785 785 785 785 785 785 785 785 424
424 785 785 785 785 785 785 785 424 424 424 721 721 721 721 721 424 424 424 785 785 785 785 785 785 785 424
424 452 454 453 424 424 424 424 424 721 721 721 721 721 721 721 721 721 424 424 424 424 424 452 454 453 424
424 721 721 721 721 721 721 721 721 721 721 721 721 721 721 721 721 721 721 721 721 721 721 721 721 721 424
424 721 721 721 721 721 721 721 721 721 721 721 656 595 657 721 721 721 721 721 721 721 721 721 721 721 424
424 721 721 721 721 721 721 721 721 721 721 721 947 625 628 721 721 721 721 721 721 721 721 721 721 721 424
424 721 721 721 721 721 721 721 721 721 721 721 947 625 628 721 721 721 721 721 721 721 721 721 721 721 424
902 902 902 902 902 902 902 902 902 902 902 749 947 625 628 902 902 902 902 902 902 902 902 902 902 902 902
897 897 897 897 897 897 897 897 897 897 897 898 452 454 453 897 897 897 897 897 897 897 897 897 897 897 897
